11111111
11000011
11000011
11000011
11111111