1111111111111
1100000000011
1100000000011
110P000000011
1111111111111