111111
111001
111101
1C0001
111101
1C0001
100E11
1010C1
1P1011
111111