1111111111111
11001C0000011
1100010C00011
1100000C00011
1100000C00011
11P0000C00E11
1111111111111