11111111111111111111
1A00000000CCCCAAAAA1
1CCCCCCCAAAAAAAAAAA1
10000000000000000001
10000000000000000001
1P0000000000000000E1
11111111111111111111