111111111111111111111111111111111111111
1A000000000000000CC000000000000000000A1
1A000000000000000CC000000000000000000A1
1A000000000000000CC000000000000000000A1
10000000000000000CC00000000000000000001
10000000000000000CC00000000000000000001
10000000000000000CC00000000000000000001
1E000000000000000CC000000000000000000P1
10000000000000000CC00000000000000000001
10000000000000000CC00000000000000000001
10000000000000000CC00000000000000000001
10000000000000000CC00000000000000000001
1A000000000000000CC000000000000000000A1
1A000000000000000CC000000000000000000A1
1A000000000000000CC000000000000000000A1
1A000000000000000CC000000000000000000A1
1A000000000000000CC000000000000000000A1
1A000000000000000CC000000000000000000A1
1A000000000000000CC000000000000000000A1
111111111111111111111111111111111111111