11111111111111111111111111111111111111111
10101010101010101010101010101010101010101
10101010101010101010101010101010101010101
10101010101010101010101010101010101010101
10101010101010101010101010101010101010101
10101010101010101010101010101010101010101
10101010101010101010101010101010101010101
10101010101010101010101010101010101010101
10101010101010101010101010101010101010101
10101010101010101010101010101010101010101
10101010101010101010101010101010101010101
10101010101010101010101010101010101010101
10101010101010101010101010101010101010101
10101010101010101010101010101010101010101
10101010101010101010101010101010101010101
1P000000000000000000000000000000000000CE1
11111111111111111111111111111111111111111
