11111111111111111111111111111111111111111111111111
1A0000000000000000000000CCCCCCC00000000000000000A1
10000000001100000000000000000000000000000000000001
11111111111100000000000000000000000000000000000001
1000000000E100000000000000000000000000000000000001
10000000000100000000000000000000000000000000000001
10000000000100000000000000000000000000000000000P01
10000000000100000000000000000000000000000000000001
10000000000100000000000000000000000000000000000001
10000000000100000000000000000000000000000000000001
1A000000000000000000000000000000000000000000000A11
11111111111111111111111111111111111111111111111111