1111111111111
1100101000011
1100000000011
110E000000011
1100000000011
11P0C00001111
1111111111111